10211011
10111211
01001010
01011200
01112001
02000111
01021100