111111111111111111111111
101003001040041110104021
121111011011100115101101
101111011011100110001101
100000020040041111100401
111211011010111204001121
111000011110020011101101
111111111111111111111111