11111111111
11021101101
11011121101
10100101001
10101120001
10111200111
10200013101
10102110001
11111111111