11111111111111111
10000000000000001
11021101100100001
11011121101121101
10100101001100021
10101120000001111
10111200111100111
10200013101110001
10102110001111101
10000000000000011
11111111111111111