10212021
10122211
00101200
02202100
01211021
00102021
02011100