1111111111
1102110111
1131210111
1001010001
1000401001
1010110011
1051000211
1000111001
1111111111