10211011
10121011
00101500
00000100
01011001
30100021
00011100