1111111111
1301323451
1000000001
1000000001
1111111111
