10211011
10121011
00101000
00000100
01011001
00100021
00011100